XXXXXXXXXXXXXXXXXXXXXXXXXXXX
XooooooooooooXXooooooooooooX
XoXXXXoXXXXXoXXoXXXXXoXXXXoX
XOXXXXoXXXXXoXXoXXXXXoXXXXOX
XooooooooooooooooooooooooooX
XoXXXXoXXoXXXXXXXXoXXoXXXXoX
XooooooXXooooXXooooXXooooooX
XXXXXXoXXXXX XX XXXXXoXXXXXX
     XoXX    1     XXoX     
     XoXX XXXXXXXX XXoX     
XXXXXXoXX X      X XXoXXXXXX
      o   X 324  X   o      
XXXXXXoXX X      X XXoXXXXXX
     XoXX XXXXXXXX XXoX     
     XoXX    C     XXoX     
XXXXXXoXX XXXXXXXX XXoXXXXXX
XooooooooooooXXooooooooooooX
XoXXXXoXXXXXoXXoXXXXXoXXXXoX
XOooXXooooooooooooooooXXooOX
XXXoXXoXXoXXXXXXXXoXXoXXoXXX
XooooooXXooooXXooooXXooooooX
XoXXXXXXXXXXoXXoXXXXXXXXXXoX
XooooooooooooooooooooooooooX
XXXXXXXXXXXXXXXXXXXXXXXXXXXX
