XXXXXXXXXXXXXXXXXXXX
X  O   O    O   O  X
X XXX X  XXX X XXX X
XOX XOX      XOX XOX
X XXX X X  X X XXX X
X     XOX  XOX     X
X XXXXX X  X XXXXX X
XOX O          O XOX
X X XXXXX O XXXX X X
X   O          O   X
X XXXXX XXXX XXXXX X
X O     X  X    O  X
X XXX X XXXX X XXX X
X X X X  O   X X X X
XOXXXOXOXXXXOXOXXXOX
X     X X  X X     X
XOXXXXX XXXX XXXXXOX
X        dssS   O  X
XXXXXXXXXXXXXXXXXXXX